7 23 12 12 12 12 12 12 7 12 12 12 12 7 24 24 7 7
23 7 7 12 12 12 12 12 7 7 12 12 12 24 24 24 24 7
12 7 7 7 12 12 12 12 7 7 12 12 24 24 24 24 24 24
12 12 7 15 12 12 12 12 7 7 12 12 24 24 24 24 24 24
12 7 7 7 15 12 12 12 7 7 12 12 24 24 24 24 24 24
12 7 12 15 7 7 12 12 7 7 12 12 24 24 24 24 24 24
12 7 12 12 7 15 12 12 12 7 7 7 7 24 24 24 24 12
12 7 12 15 15 7 12 12 0 21 0 7 7 7 7 24 12 12
12 7 7 7 7 15 7 0 0 7 0 0 7 23 7 24 12 12
12 12 12 12 7 7 7 32 7 7 7 0 7 12 7 24 12 12
13 13 12 7 7 7 7 0 7 7 7 32 7 23 7 24 12 12
6 13 6 6 7 7 0 0 7 7 7 24 7 7 7 24 12 12
6 0 0 0 21 0 0 7 7 7 7 24 24 7 24 24 12 12
31 0 6 31 6 30 7 6 7 7 7 7 24 24 24 12 12 12
0 0 6 6 7 7 7 6 6 7 7 7 7 7 12 12 12 12
31 6 6 31 13 13 31 7 6 6 7 7 7 12 12 12 12 12
31 31 6 13 13 13 31 12 12 12 12 12 12 12 12 12 12 12
31 31 13 13 13 13 13 12 13 12 12 12 12 12 12 12 12 10